1111111111111111111
1000G000C0000001111
1001011111000001111
10010000C0000P01111
10010000G0000E01G11
10001111101100000C1
1111111111111111111