1111111111111111
1000G000C000G001
1001011111000001
1C010000C0000P01
10010000G0000E01
1111111111111111