1111111111111111111
10000000C0000001111
1001011111000P01111
10010000C0000111111
1001000000001E01111
10001111101100000C1
1111111111111111111