1111111111111
100100C0000C1
1C00011111E01
100011E00P001
1111111111111
